R 680 480
NO ./textures/mononoke.xpm
SO ./textures/mimi.xpm
WE ./textures/chihiro.xpm
EA ./textures/ged.xpm

S ./textures/pen.xpm

C 126,200,250
F 160,250,150

1111111111111111111111111
1000000000110000000000001
1011000001110000002000001
1001000000000000000000001
111111111011000001110000100000001
100000000011000001110111111111111
11110111111111010000000010001
11110111111111011101010010001
11000000110101011122200010001
1000200000000222     0001020111
1000000000000    222210000001
1100000111010101111101111 N 0111
11110111 1110101 101111010001
11111111 1111111 111111111111